=,=,=,=,=,=,=,=,=,=,=,=,=,=,=,=,=,=,=,=,=,=,=,=,=,=,=,=,=,=,=,=,=,=,=,=,=,=,=,=,=,=,=,=,=,=,=,=,=,=,=,=,=,=,=,=,=,=,=,=,=,=,=,=,=,=,=,=,=,=,=,=,=,=,,
|, ,*, ,|, , , , , , , , , , ,|, , , , , , , , , , , ,|, , , , ,|, , , , , , , , , , , , , ,|, , , , , , , ,|, , , , , , , , , , , , ,|, , , , , ,|,,
|, ,=,=,+, ,+,=,+,=,=,=,=,=, ,+, ,=,=,=, ,=,=,=,=,=,=,=,=,=,=, ,+, ,=,=,=,=,=,=,=,=,=,=, , ,+,=,=,=,=,=,+, ,|, ,z,x,x,=,=,=,=,=,+,z, ,|, ,=,=,+, ,|,,
|, , , , , ,|, ,|, , , , , , , , , , ,|, , ,|, , , , , , , , , ,|, , , , , , , , , , , ,|, ,+,=,=,=,=,=,+, , , , , ,|, , , , , , , , ,|, , , ,|, ,|,,
|,=,=,=,=,=,+, ,|, ,+,=,=,=,=,=,=,=,=,=, , ,+,=,=,=,=,=,=,=,=, , , ,+,=,=,=,=,=,=,=,=, ,+, ,|, , , , , ,|, ,+, ,x,x,x,=,=,=,=,=,+, , , , ,+,=,=, ,|,,
|, , , , , , , , , ,|, , , , , , , , ,x, , , , , , , , , , , , ,|,=,=, , ,|, , , , , , , , , , ,+,=,+, , , ,|, , , , , , , , , , , ,=,=,=,|, ,O, ,|,,
|,=,=,=,=,=,=,=,=,=,=,=,=,=,=,=,=,=,=,=,=,=,=,=,=,=,=,=,=,=,=,=,=,=,=,=,=,=,=,=,=,=,=,=,=,=,=,=,=,=,=,=,=,=,=,=,=,=,=,=,=,=,=,=,=,=,=,=,=,=,=,=,=,|,,

