=,=,=,=,=,=,=,=,=,=,=,=,=,=,=,=,=,=,=,=,=,=,=,=,=,=,=,=,=,=,=,=,=,=,=,=,=,=,=,=,=,=,=,=,=,=,=,=,=,=,=,=,=,=,=,=,=,=,=,=,=,=,=,=,=,=,=,=,=,=,=,=,=,=,,
|, ,*, ,|, , , , , , , , , , ,|, , , , , , , , , , , , , , , , ,|, , , , , , , , , , , , , ,|, , , , , , , ,|, , , , , , , , , , , , ,|, , , , , ,|,,
|, ,=,=,+, ,+,=,+,=,=,=,=,=, ,+, ,=,=,=,=,=,=,=,=, ,=,=,=,=,=,=,+, ,=,=,=,=,=,=,=,=,=,=, , ,+,=,=,=,=,=,+, ,|, ,z,x,x,=,=,=,=,=,+,z, ,|, ,=,=,+, ,|,,
|, , , , , ,|, ,|, , , , , , , , , , ,|, , , , , , , , , , , , ,|, , , , , , , , , , , ,|, ,+,=,=,=,=,=,+, , , , , ,|, , , , , , , , ,|, , , ,|, ,|,,
|,=,=,=,=,=,+, ,|, ,+,=,=,=,=,=,=,=,=,=, , ,+,=,=,=,=,=,=,=,=, , , ,+,=,=,=,=,=,=,=,=, ,+, ,|, , , , , ,|, ,+, ,x,x,x,=,=,=,=,=,+, , , , ,+,=,=, ,|,,
|, , , , , , , , , ,|, , , , , , , , , , , ,|, , , , , , , , , ,|,=,=, , ,|, , , , , , , , , , ,+,=,+, , , ,|, , , , , , , , , , , ,=,=,=,|, ,O, ,|,,
|,=,=,=,=,=,=,=,=,=,=,=,=,=,=,=,=,=,=,=,=,=,=,=,=,=,=,=,=,=,=,=,=,=,=,=,=,=,=,=,=,=,=,=,=,=,=,=,=,=,=,=,=,=,=,=,=,=,=,=,=,=,=,=,=,=,=,=,=,=,=,=,=,|,,

